let Abaxial = new Jogador(C,"Abaxial",EstadosUnidos);
let Absolut = new Jogador(BOT,"Absolut",Brasil);
let Aegis = new Jogador(JG,"Aegis",Brasil);
let Aladoric = new Jogador(SUP,"Aladoric",Australia);
let Alocs = new Jogador(A,"Alocs",Brasil);
let Any = new Jogador(MID,"Anyyy",Brasil);
let Aoshi = new Jogador(C,"Aoshi",Brasil);
let Asper = new Jogador(SUP,"Asper",CoreiaDoSul);
let Asta = new Jogador(JG,"Asta",Brasil);
let Avenger = new Jogador(MID,"Avenger",Brasil);
let Ayel = new Jogador(TOP,"Ayel",Brasil);
let Bankai = new Jogador(TOP,"Bankai",Brasil);
let Beenie = new Jogador(BOT,"Beenie",Brasil);
let Beelzy = new Jogador(C,"Beelzy",Brasil);
let Betao = new Jogador(TOP,"Betao",Brasil);
let Bigfafa = new Jogador(C,"Bigfafa",CoreiaDoSul);
let Blacky = new Jogador(MID,"Blacky",Brasil);
let Boal = new Jogador(TOP,"Boal",Brasil);
let BocaJR = new Jogador(SUP,"BocaJR",Brasil);
let Bounty = new Jogador(SUP,"Bounty",Brasil);
let BP = new Jogador(A,"BP",Portugal);
let Brance = new Jogador(BOT,"Brance",Brasil);
let Brandao = new Jogador(A,"Brandao",Brasil);
let Brucer = new Jogador(MID,"Brucer",Brasil);
let Buggax = new Jogador(TOP,"Buggax",Uruguai);
let Bydeki = new Jogador(BOT,"Bydeki",Brasil);
let brTT = new Jogador(BOT,"brTT",Brasil);
let Bugi = new Jogador(JG,"Bugi",CoreiaDoSul);
let Bvoy = new Jogador(BOT,"Bvoy",CoreiaDoSul);
let Cabu = new Jogador(SUP,"Cabu",Brasil);
let Canna = new Jogador(TOP,"Canna",CoreiaDoSul);
let Caos = new Jogador(A,"Caos",Brasil);
let CarioK = new Jogador(JG,"CarioK",Brasil);
let Cavalo = new Jogador(SUP,"Cavalo",Brasil);
let Ceos = new Jogador(SUP,"Ceos",Brasil);
let Celo = new Jogador(BOT,"Celo",Brasil);
let Cepted = new Jogador(MID,"Cepted",CoreiaDoSul);
let Coelho = new Jogador(C,"Coelho",Brasil);
let Croc = new Jogador(JG,"Croc",CoreiaDoSul);
let Crowe = new Jogador(C,"Crowe",EstadosUnidos);
let CuVee = new Jogador(TOP,"CuVee",CoreiaDoSul);
let Damage = new Jogador(SUP,"Damage",Brasil);
let Decoy = new Jogador(SUP,"Decoy",NovaZelandia);
let Diamondprox = new Jogador(JG,"Diamondprox",Russia);
let Dionrray = new Jogador(C,"Dionrray",Brasil);
let Disamis = new Jogador(JG,"Disamis",Brasil);
let Disave = new Jogador(BOT,"Disave",Brasil);
let Djoko = new Jogador(C,"Djoko",Brasil);
let DonArts = new Jogador(JG,"DonArts",Alemanha);
let DoRun = new Jogador(TOP,"DoRun",CoreiaDoSul);
let Drop = new Jogador(BOT,"Drop",Brasil);
let DudsTheBoy = new Jogador(BOT,"DudsTheBoy",Brasil);
let Dynquedo = new Jogador(MID,"Dynquedo",Brasil);
let Edward = new Jogador(C,"Edward",Armenia);
let Elramir = new Jogador(JG,"Elramir",Turquia);
let Enga = new Jogador(MID,"Enga",Argentina);
let Envy = new Jogador(MID,"Envy",Brasil);
let Erasus = new Jogador(JG,"Erasus",Brasil);
let eSa = new Jogador(SUP,"eSa",Brasil);
let Evrot = new Jogador(MID,"Evrot",Brasil);
let Expect = new Jogador(TOP,"Expect",CoreiaDoSul);
let Flare = new Jogador(BOT,"Flare",Brasil);
let fnB = new Jogador(TOP,"fnB",Brasil);
let Follow = new Jogador(JG,"Follow",Argentina);
let FrostStrike = new Jogador(JG,"FrostStrike",Chile);
let Furyz = new Jogador(A,"Furyz",Brasil);
let Gafone = new Jogador(C,"Gafone",Brasil);
let Garo = new Jogador(BOT,"Garo",Brasil);
let GeumGo = new Jogador(JG,"GeumGo",CoreiaDoSul);
let Goku = new Jogador(MID,"Goku",Brasil);
let Goot = new Jogador(JG,"Goot",Brasil);
let Grell = new Jogador(JG,"Grell",Mexico);
let Grevthar = new Jogador(MID,"Grevthar",Brasil);
let Guard = new Jogador(SUP,"Guard",CoreiaDoSul)
let Guigo = new Jogador(TOP,"Guigo",Brasil);
let Hades = new Jogador(BOT,"Hades",CoreiaDoSul);
let Harumi = new Jogador(SUP,"Harumi",Brasil);
let Halier = new Jogador(A,"Halier",Brasil);
let Hauz = new Jogador(MID,"Hauz",Brasil);
let Hawk = new Jogador(SUP,"Hawk",Brasil);
let Hidan = new Jogador(TOP,"Hidan",Brasil);
let Hiro = new Jogador(C,"Hiro",CoreiaDoSul);
let Hugato = new Jogador(JG,"Hugato",Brasil);
let JackPot = new Jogador(TOP,"JackPot",CoreiaDoSul);
let JeanMago = new Jogador(MID,"Jean Mago",Brasil);
let Jisu = new Jogador(TOP,"Jisu",CoreiaDoSul);
let Jockster = new Jogador(SUP,"Jockster",Brasil);
let JoJo = new Jogador(SUP,"JoJo",Brasil);
let Juc = new Jogador(A,"Juc",Brasil);
let Juliera = new Jogador(BOT,"Juliera",Brasil);
let Juzo = new Jogador(BOT,"Juzo",Brasil);
let KaKaO = new Jogador(JG,"KaKaO",CoreiaDoSul);
let Kalec = new Jogador(C,"Kalec",Brasil);
let Kennedys = new Jogador(TOP,"Kennedys",Brasil);
let Khorn = new Jogador(A,"Khorn",Brasil);
let Kiari = new Jogador(TOP,"Kiari",Brasil);
let Kick = new Jogador(MID,"Kick",Brasil);
let Kim = new Jogador(C,"Kim",Brasil);
let Kira = new Jogador(A,"Kira",Brasil);
let Krastyel = new Jogador(MID,"Krastyel",Brasil);
let Kuri = new Jogador(SUP,"Kuri",CoreiaDoSul);
let Lapis = new Jogador(TOP,"Lapis",CoreiaDoSul);
let Lonely = new Jogador(TOP,"Lonely",CoreiaDoSul);
let Loreviz = new Jogador(C,"Loreviz",Brasil);
let Luci = new Jogador(SUP,"Luci",CoreiaDoSul);
let Luskka = new Jogador(BOT,"Luskka",Brasil);
let Maestro = new Jogador(C,"Maestro",Brasil);
let Matsu = new Jogador(BOT,"Matsu",Brasil);
let Mewkyo = new Jogador(JG,"Mewkyo",Brasil);
let micaO = new Jogador(BOT,"micaO",Brasil);
let Mickey = new Jogador(MID,"Mickey",CoreiaDoSul);
let Mido = new Jogador(SUP,"Mido",Brasil);
let Mills = new Jogador(BOT,"Mills",Brasil);
let Minerva = new Jogador(JG,"Minerva",Brasil);
let Mocha = new Jogador(SUP,"Mocha",CoreiaDoSul);
let Netuno = new Jogador(BOT,"Netuno",Brasil);
let Newbie = new Jogador(SUP,"Newbie",Argentina);
let NinjaKiwi = new Jogador(BOT,"NinjaKiwi",Brasil);
let Nishikino = new Jogador(A,"Nishikino",Brasil);
let NosFerus = new Jogador(MID,"NosFerus",Brasil);
let Nova = new Jogador(C,"Nova",Turquia);
let Nuddle = new Jogador(C,"Nuddle",Canada);
let Oddie = new Jogador(JG,"Oddie",Peru);
let Onmeta = new Jogador(A,"Onmeta",Brasil);
let Pades = new Jogador(C,"Pades",Turquia);
let Parang = new Jogador(TOP,"Parang",CoreiaDoSul);
let pbO = new Jogador(BOT,"pbO",Brasil);
let Piloto = new Jogador(MID,"Piloto",Brasil);
let Pirean = new Jogador(MID,"Pirean",CoreiaDoSul);
let Pit = new Jogador(A,"Pit",Brasil);
let Politico = new Jogador(C,"Politico",Brasil);
let ProDelta = new Jogador(SUP,"ProDelta",Brasil);
let Professor = new Jogador(SUP,"Professor",Brasil);
let RafaP = new Jogador(A,"RafaP",Brasil);
let Rainbow = new Jogador(MID,"Rainbow",CoreiaDoSul);
let Ranger = new Jogador(JG,"Ranger",Brasil);
let Raven = new Jogador(A,"Raven",Portugal);
let RedBert = new Jogador(SUP,"RedBert",Brasil);
let Revolta = new Jogador(JG,"Revolta",Brasil);
let Riyev = new Jogador(SUP,"Riyev",Brasil);
let Robo = new Jogador(TOP,"Robo",Brasil);
let Ryan = new Jogador(JG,"Ryan",CoreiaDoSul);
let Sacre = new Jogador(TOP,"Sacre",Croacia);
let Scuro = new Jogador(SUP,"Scuro",Brasil); 
let Sephis = new Jogador(JG,"Sephis",Brasil); 
let Shini = new Jogador(JG,"Shini",Brasil);
let ShowMaker = new Jogador(MID,"ShowMaker",CoreiaDoSul);
let Shrimp = new Jogador(JG,"Shrimp",CoreiaDoSul);
let Sive = new Jogador(SUP,"Sive",CoreiaDoSul);
let Skeeto = new Jogador(TOP,"Skeeto",Chile);
let Skybart = new Jogador(TOP,"Skybart",Brasil);
let Smeb = new Jogador(TOP,"Smeb",CoreiaDoSul);
let Snaker = new Jogador(BOT,"Snaker",Argentina);
let Snowflower = new Jogador(SUP,"Snowflower",CoreiaDoSul);
let Snowlz = new Jogador(C,"Snowlz",Brasil)
let Stardust = new Jogador(C,"Stardust",CoreiaDoSul);
let St1ng = new Jogador(JG,"St1ng",Brasil);
let Stepz = new Jogador(BOT,"Stepz",Brasil);
let SuperCleber = new Jogador(TOP,"SuperCleber",Brasil);
let Taxer = new Jogador(JG,"Taxer",Dinamarca);
let Tay = new Jogador(TOP,"Tay",Brasil);
let Telas = new Jogador(SUP,"Telas",Brasil);
let Tinowns = new Jogador(MID,"Tinowns",Brasil);
let TioBen = new Jogador(A,"TioBen",Brasil);
let Titan = new Jogador(BOT,"Titan",Brasil);
let Tockers = new Jogador(C,"Tockers",Brasil);
let Trap = new Jogador(TOP,"Trap",CoreiaDoSul);
let Trigo = new Jogador(BOT,"Trigo",Brasil);
let Truklax = new Jogador(TOP,"Truklax",Portugal);
let Turtle = new Jogador(C,"Turtle",Brasil);
let Tusin = new Jogador(SUP,"Tusin",CoreiaDoSul);
let Tutsz = new Jogador(MID,"Tutsz",Brasil);
let Tyrin = new Jogador(TOP,"Tyrin",Brasil);
let Von = new Jogador(C,"Von",Brasil);
let VulcanicDog = new Jogador(JG,"Vulcanic Dog",Argentina);
let VVVert = new Jogador(TOP,"VVVert",Brasil);
let Wiz = new Jogador(JG,"Wiz",CoreiaDoSul);
let Wizer = new Jogador(TOP,"Wizer",CoreiaDoSul);
let Woodboy = new Jogador(SUP,"Woodboy",Brasil);
let Wos = new Jogador(SUP,"Wos",Brasil);
let Xero = new Jogador(A,"Xero",CoreiaDoSul);
let Yampi = new Jogador(JG,"Yampi",Brasil);
let Yang = new Jogador(TOP,"Yang",Brasil);
let Yuri = new Jogador(MID,"Yuri",CoreiaDoSul);
let Zay = new Jogador(SUP,"Zay",Brasil);
let Zirigui = new Jogador(SUP,"Zirigui",Brasil);
let Zuao = new Jogador(JG,"Zuao",Brasil)

let AnonTopBR = new Jogador(TOP,"???",Brasil)
let AnonJgBR = new Jogador(JG,"???",Brasil)
let AnonMidBR = new Jogador(MID,"???",Brasil)
let AnonAdcBR = new Jogador(BOT,"???",Brasil)
let AnonSupBR = new Jogador(SUP,"???",Brasil)
let AnonCoachBR = new Jogador(C,"???",Brasil)

let AnonTopKR = new Jogador(TOP,"???",CoreiaDoSul)
let AnonJgKR = new Jogador(JG,"???",CoreiaDoSul)
let AnonMidKR = new Jogador(MID,"???",CoreiaDoSul)
let AnonAdcKR = new Jogador(BOT,"???",CoreiaDoSul)
let AnonSupKR = new Jogador(SUP,"???",CoreiaDoSul)
let AnonCoachKR = new Jogador(C,"???",CoreiaDoSul)